################################
#                              #
#                              #
#                              #
#  #####                       #
#  #   #                       #
#  #   #                       #
#      ########                #
#      #                       #
#      #                       #
#      #                       #
#      #                       #
#      #                       #
#      #                       #
#      #                       #
#      #                       #
#      #                       #
#      #                       #
#      #                       #
#      #                       #
################################
